DTTTTTTTTTTTTTTTTTTD
LZZZZZZZLYYRZZZZZZZR
LZDDZDDZLYYRZDDZDDZR
LZUUZUUZUBBUZUUZUUZR
LZZZZZZZZZZZZZZZZZZR
LZZZZZZZZZZZZZZZZZZR
LZZZZZZZZZZZZZZZZZZR
LZZZZZZZZZZZZZZZZZZR
WWWWWWZGGXGGZWWWWWWW
YYYYYYZGXXXGZYYYYYYY
YYYYYYZGXXXGZYYYYYYY
YYYYYYZGXXXGZYYYYYYY
WWWWWWZGGGGGZWWWWWWW
LZZZZZZZZZSZZZZZZZZR
LZZZZZZZZZZZZZZZZZZR
LZZZZZZZZZZZZZZZZZZR
LZZZZZZZZZZZZZZZZZZR
LZDDZDDZDTTDZDDZDDZR
LZUUZUUZLYYRZUUZUUZR
LZZZZZZZLYYRZZZZZZZR
UBBBBBBBBBBBBBBBBBBU