CTTTTTTTTTTTTTTTTTTC
LZZZZZZZLYYRZZZZZZZR
LZOOZOOZLYYRZOOZOOZR
LZOOZOOZCBBCZOOZOOZR
LZZZZZZZZZZZZZZZZZZR
CMMMMMZGGXGGZMMMMMMC
YYYYYYZGXXXGZYYYYYYY
YYYYYYZGXXXGZYYYYYYY
CMMMMMZGGGGGZMMMMMMC
LZZZZZZZZZSZZZZZZZZR
LZOOZOOZCTTCZOOZOOZR
LZOOZOOZLYYRZOOZOOZR
LZZZZZZZLYYRZZZZZZZR
CBBBBBBBBBBBBBBBBBBC