DTTTTTTTTTTTTTTTTTTD
LZZZZZZZLYYRZZZZZZZR
LZOOZDDZLYYRZOOZDDZR
LZOOZUUZCBBCZOOZUUZR
LZZZZZZZZZZZZZZZZZZR
DWWWWWZGGXGGZWWWWWWD
YYYYYYZGXXXGZYYYYYYY
YYYYYYZGXXXGZYYYYYYY
UWWWWWZGGGGGZWWWWWWU
LZZZZZZZZZSZZZZZZZZR
LZDDZDDZDTTDZDDZDDZR
LZUUZUUZLYYRZUUZUUZR
LZZZZZZZLYYRZZZZZZZR
UBBBBBBBBBBBBBBBBBBU