DTTTTTTTTTTTTTTTTTTD
LZZZZZZZLYYRZZZZZZZR
LZTTZTTZLYYRZTTZTTZR
LZUUZUUZUBBUZUUZUUZR
LZZZZZZZZZZZZZZZZZZR
LZZZZTTTTTTTTTTTZZZR
LZZZZZZZZZZZZZZZZZZR
LZZZZZZZZZZZZZZZZZZR
UTTTTTZGGXGGZTTTTTTU
LOOZZZZGXXXGZZZZOOOR
UTTTTTZGXXXGZTTTTTTU
WOOZZZZGXXXGZZZZOOOW
DBBBBBZGGGGGZBBBBBBD
LZZZZZZZZZSZZZZZZZZR
LZZZZZZZZZZZZZZZZZZR
LZZZTTTTZZZZTTTTZZZR
LZZZZZZZZZZZZZZZZZZR
LZTTZTTZDTTDZTTZTTZR
LZUUZUUZLYYRZUUZUUZR
LZZZZZZZLYYRZZZZZZZR
BBBBBBBBBBBBBBBBBBBB