WWWWWWWWWWWWWWWWWWWW
WZZZZZZZWYYWZZZZZZZW
WZWWZWWZWYYWZWWZWWZW
WZWWZWWZWWWWZWWZWWZW
WZZZZZZZZZZZZZZZZZZW
YWWWWWZWWXWWZWWWWWWY
YYYYYYZWXXXWZYYYYYYY
YYYYYYZWXXXWZYYYYYYY
YWWWWWZWWWWWZWWWWWWY
WZZZZZZZZZZZZZZZZZZW
WZWWZWWZWWWWZWWZWWZW
WZWWZWWZWYYWZWWZWWZW
WZZZZZZZWYYWZZZZZZZW
WWWWWWWWWWWWWWWWWWWW